3 idiots-Give Me Some Sunshine.mp3
Adele - Someone Like You.mp3
a-ha - Take On Me (Official Video).mp3
Alphaville - Forever Young -Official Video.mp3
Baby - Justin Bieber.mp3
Bad Day - Daniel Powter.mp3
Beyonce-If I were a boy(lyrics).mp3
Bon Jovi - It's my life w- lyrics.mp3
Bruno Mars - Just The Way You Are  [Lyrics On Screen].mp3
Can you Feel The Love tonight, Lion King (with lyrics).mp3
Carly Rae Jepsen - Call Me Maybe.mp3
Counting Stars - OneRepublic.mp3
Demons - Imagine Dragons.mp3
Eenie Meenie - Sean Kingston And Justin Bieber.mp3
Eminem - Love The Way You Lie ft. Rihanna.mp3
Flo Rida - Whistle [Official Video].mp3
I'm Yours - Jason Mraz.mp3
It's Time - Imagine Dragons.mp3
Jack Johnson Taylor with Lyrics.mp3
James Blunt - You're Beautiful (Video).mp3
Jessie J - Price Tag ft. B.o.B..mp3
John Denver - Take Me Home, Country Roads.mp3
Leave Out All The Rest (Album Version) - Linkin Park.mp3
Lenka - The Show (New Version).mp3
Maroon 5 - Love Somebody.mp3
Maroon 5 - She Will Be Loved.mp3
Michael Jackson - Man In The Mirror.mp3
Pitbull - International Love ft. Chris Brown.mp3
Shooting Star - Owl City.mp3
Taylor Swift- Last Christmas (Lyrics).mp3
The Beatles - Let it be Lyrics.mp3
The Calling - Wherever You Will Go.mp3
THE DOWNTOWN FICTION - I Just Wanna Run [OFFICIAL MUSIC VIDEO].mp3
The Fray - You Found Me.mp3
Timbaland - Apologize ft. OneRepublic.mp3
Train - Hey, Soul Sister.mp3
U2 - With Or Without You.mp3
Warriors - Imagine Dragons.mp3
Wavin'  Flag - K Naan.mp3
When Can I See You Again_ - Owl City.mp3
